7 7
R
W W W W W W W
I F F F F F W
W W W W W F W
W F F F F F W
W F W W W W W
W F F F F F O
W W W W W W W